1a 1b 2 2 1c 1d
1 1 3 3 1 1
0 0 1 1 0 0
-
2 2 3 3 2 2
1 1 3 3 1 1
3 3 2 2 3 3
-